10x5
1111111112
.........3
g.dBCF1..3
....*....4
o.t.l.b.m.
