10x5
1111111112
.........3
...BCF1..3
....*....4
..t.l.b.m.