10x5
1111111112
.........3
..dBCF1..3
....*....4
..t.l.b.m.
