10x5
1111111112
.........3
..dBCFT..3
....*....3
t.o.l.b.m.
